luigi: fighter/luigi/param/hdr.xml
pikmin: fighter/pikmin/param/hdr.xml
lucas: fighter/lucas/param/hdr.xml
lucario: fighter/lucario/param/hdr.xml
pichu: fighter/pichu/param/hdr.xml
ike: fighter/ike/param/hdr.xml
donkey: fighter/donkey/param/hdr.xml
dolly: fighter/dolly/param/hdr.xml
chrom: fighter/chrom/param/hdr.xml
captain: fighter/captain/param/hdr.xml
pacman: fighter/pacman/param/hdr.xml
mario: fighter/mario/param/hdr.xml
mariod: fighter/mariod/param/hdr.xml
link: fighter/link/param/hdr.xml
simon: fighter/simon/param/hdr.xml
richter: fighter/richter/param/hdr.xml
koopajr: fighter/koopajr/param/hdr.xml
demon: fighter/demon/param/hdr.xml
samus: fighter/samus/param/hdr.xml
samusd: fighter/samusd/param/hdr.xml
edge: fighter/edge/param/hdr.xml
szerosuit: fighter/szerosuit/param/hdr.xml
pit: fighter/pit/param/hdr.xml
pitb: fighter/pitb/param/hdr.xml
toonlink: fighter/toonlink/param/hdr.xml
younglink: fighter/younglink/param/hdr.xml
daisy: fighter/daisy/param/hdr.xml
miiswordsman: fighter/miiswordsman/param/hdr.xml
duckhunt: fighter/duckhunt/param/hdr.xml
krool: fighter/krool/param/hdr.xml
ganon: fighter/ganon/param/hdr.xml
miifighter: fighter/miifighter/param/hdr.xml
sheik: fighter/sheik/param/hdr.xml
miigunner: fighter/miigunner/param/hdr.xml
falco: fighter/falco/param/hdr.xml
ness: fighter/ness/param/hdr.xml
ryu: fighter/ryu/param/hdr.xml
ken: fighter/ken/param/hdr.xml
littlemac: fighter/littlemac/param/hdr.xml