luigi: fighter/luigi/param/hdr.prc
pikmin: fighter/pikmin/param/hdr.prc
lucas: fighter/lucas/param/hdr.prc
lucario: fighter/lucario/param/hdr.prc
pichu: fighter/pichu/param/hdr.prc
ike: fighter/ike/param/hdr.prc
donkey: fighter/donkey/param/hdr.prc
dolly: fighter/dolly/param/hdr.prc
chrom: fighter/chrom/param/hdr.prc
captain: fighter/captain/param/hdr.prc
pacman: fighter/pacman/param/hdr.prc
mario: fighter/mario/param/hdr.prc
mariod: fighter/mariod/param/hdr.prc
link: fighter/link/param/hdr.prc
simon: fighter/simon/param/hdr.prc
richter: fighter/richter/param/hdr.prc
koopajr: fighter/koopajr/param/hdr.prc
demon: fighter/demon/param/hdr.prc
samus: fighter/samus/param/hdr.prc
samusd: fighter/samusd/param/hdr.prc
edge: fighter/edge/param/hdr.prc
szerosuit: fighter/szerosuit/param/hdr.prc
pit: fighter/pit/param/hdr.prc
pitb: fighter/pitb/param/hdr.prc
toonlink: fighter/toonlink/param/hdr.prc
younglink: fighter/younglink/param/hdr.prc
daisy: fighter/daisy/param/hdr.prc
miiswordsman: fighter/miiswordsman/param/hdr.prc
duckhunt: fighter/duckhunt/param/hdr.prc
krool: fighter/krool/param/hdr.prc
ganon: fighter/ganon/param/hdr.prc
miifighter: fighter/miifighter/param/hdr.prc